2523417448
2523716476
2523462540
2523303024
2523491584
2523404608
2523599576
2523390436
2523594464
2523278928
2523491480
2523486184
2523597536
2524038236
2523834408
2523515280
2523454820
2523320968
2526356212
2523281596
2523592464
2523031292
2523166572
2523305520
2523699456
2523793760
2523313212
2523509300
2525898196
2523049920
2523794348
2523343720
2522986232
2523229280
2523339876
2523708880
2541212808
2523938700
2523228584
2523374844
2523375956
2523341500
2523494292
2523553048
2523251452
2523046304
2529551428
2523257688
2523089116
2523112124
2523131868
2523114304
2523316500
2523046316
2533229696
2523487892
2523288352
2523150128
2523233968
2523259280
2523049196
2523390208
2523864724
2523781472
2523298940
2523583536
2523578232
2523513320
2523412828
2523801848
2523174428
2523792464
2523410356
2523346940
2523116464
2523341840
2523298728
2523180376
2523368716
2523540056
2523330204
2523366960
2523228184
2523123520
2523182212
2523312684
2524063756
2523315448
2523066040
2523029272
2523251292
2529170928
2523290952
2522856468
2523374092
2523761452
2522925976
2523229072
2523027632
2523206852
