2528045044
2528390588
2528085104
2528905780
2528665860
2528159148
2528988092
2528135360
2530042856
2528527400
2528234820
2528583704
2528583200
2528432932
2528730768
2528747796
2528593308
2528262552
2528334420
2528189672
2528669836
2528735988
2528028332
2528279876
2529206748
2528269444
2528013520
2528237960
2528051876
2528643288
2528302800
2528572568
2528540680
2528245828
2528419904
2528757364
2527966968
2529045232
2528464224
2528375172
2527969612
2538440140
2535519344
2527947128
2528588572
2528291292
2528430072
2528233448
2528442396
2528360476
2528957752
2531738964
2528287172
2528466544
2528456416
2528052960
2528635016
2528567000
2528035968
2528122876
2528440492
2528263232
2528522368
2528491184
2528051600
2528295252
2528768412
2528244952
2528648628
2528622264
2528338240
2528041684
2528277940
2528507808
2528165856
2528245020
2528000260
2528494864
2528491084
2528414872
2528087172
2527962404
2528660860
2531288604
2531343500
2532024428
2528220472
2528498120
2528445352
2528202636
2528453076
2527894180
2528418768
2528169372
2528245344
2528439104
2527950544
2528504520
2528381924
2528596808
