220339476
220484532
220681132
220583956
220484952
220677428
220475952
220548864
220505880
220581576
220538280
220480300
220585232
220636292
220559896
220548684
220509260
220605528
220603224
220617724
220528652
220538848
220524064
220535636
220531044
220476648
220459368
220567996
220739972
220493944
220444868
220589148
220569116
220600108
220438232
220476144
220652324
220518560
220559848
220511536
220591480
220485684
220578864
220513948
220487132
220600496
220636004
220610076
220513504
220502176
220443452
220483068
220588052
220523540
220568552
220535764
220610436
220501044
220541636
220550664
220514100
220664876
220557356
220450904
220491912
220638168
220504076
220588316
220486860
220533744
220434712
220635252
220580896
220449564
220467624
220660736
220586696
220836500
220577424
220428124
220467004
220493036
220410708
220628476
220387744
220975160
221036012
220530696
220703584
220530932
220462760
220528756
220440632
220628596
220611084
220572992
220520204
220479980
220514980
220427524
