27950045160
27949842508
13443916032
8294249164
8291371244
8293688044
8649659712
8685452856
8672114340
8646044040
8670531052
8666787108
8663848324
8642573396
8634688648
8664816132
8679617964
8664336132
8684974016
8666426744
8624891996
8655697680
8693861804
8664398484
8681141988
8676766492
8688693320
8683233868
8676014128
8685010696
8659139560
8671468008
8673078720
8659710540
8658837748
8675206368
8676461932
8689111404
8664745992
8675830500
8671173304
8675079992
8674267564
8660653628
8693303180
8673885300
8668850756
8678996956
8676152156
8694557904
8685365372
8668097612
8671994084
8649878288
8649185848
8658781496
8678955604
8678561124
8656445112
8666749120
8648146716
8625383172
8629878644
8650721640
8675561912
8673657776
8686208904
8636585000
8665010072
8681418700
8690217872
8683891048
8667801368
8657253460
8671216256
8671175072
8685160016
8690950776
8694074640
8679571872
8681858892
8686328104
8681394124
8681663788
8688636268
8667625704
8662851480
8662881980
8672294856
8675512704
8661132444
8670830296
8701819168
8684129436
8642067440
8678254808
8660216416
8658682908
8636340500
8661709624
