2084885708
2084132616
2086189944
2086399264
2087963580
2087335212
2086616684
2086850856
2085275520
2085611144
2085025556
2085782804
2086451996
2086520244
2084847884
2085557024
2084417496
2084442380
2083580656
2085792712
2084413728
2085338424
2084978372
2085434024
2085583600
2085525336
2084505076
2085117020
2086027844
2085547344
2085787012
2086561868
2085657888
2085142440
2084844784
2086011100
2085582972
2088442072
2086104288
2086952936
2089064308
2087089324
2085291172
2084465940
2086097544
2084898212
2084729644
2086228468
2085653304
2086726056
2086459248
2085926648
2090870536
2086456036
2087382196
2086943716
2086974864
2085044052
2087457736
2087245236
2088621100
2091226092
2086236524
2085839456
2086880636
2085944088
2087012952
2086721808
2086161256
2085530988
2085945040
2085245676
2085150148
2085171964
2086829688
2085721768
2085392416
2085443712
2089487608
2086050604
2086283744
2086344268
2086587216
2087382524
2085427180
2087149704
2086375872
2088727804
2086624148
2086237800
2085667108
2086788416
2086127096
2085337592
2085021916
2085204380
2087020416
2086309428
2086184968
2085382552
